ATL - Atlanta Hawks 
BOS - Boston Celtics
BKN - Brooklyn Nets
CHA - Charlotte Bobcats
CHI - Chicago Bulls
CLE - Cleveland Cavaliers
DAL - Dallas Mavericks
DEN - Denver Nuggets
DET - Detroit Pistons
GSW - Golden State Warriors
HOU - Houston Rockets
IND - Indiana Pacers
LAC - Los Angeles Clipper
LAL - Los Angeles Lakers
MEM - Memphis Grizzles
MIA - Miami Heat
MIL - Milwaulkee Bucks
MIN - Minnesota Timberwolves
NJN - New Jersey Nets
NOH - New Orleans Hornets
NYK - New York Knicks
OKC - Oklahoma City Thunder
ORL - Orlando Magic
PHX - Phoenix Suns
POR - Portland Trail Blazers
SAC - Sacramento Kings
SAS - San Antonio Spurs
TOR - Toronto Raptors
UTA - Utah Jazz
WAS - Washington Wizards

Leia mais: https://futfe.webnode.com.br/news/curiosidades-siglas-dos-times-da-nba/